%%%%%%%%%%%%%%
%           P%
%            %
%            %
%            %
%            %
%            %
%            %
%     .      %
%            %
%            %
%            %
%            %
%%%%%%%%%%%%%%
