%%%%%%%%%%
%.      P%
%        %
%        %
%%%%%%%%%%
